+++++++++++++
+j----------+
+-+++---+++-+
+-+-------+-+
+-+-++ ++-+-+
--+-+ a +-+--
--+-+aaa+-+--
+-+-+++++-+-+
+-+-------+-+
+-+++---+++-+
+-----------+
+++++++++++++